//MAP CONVERTED BY dmm2tgm.py THIS HEADER COMMENT PREVENTS RECONVERSION, DO NOT REMOVE
"aC" = (
/obj/structure/railing/corner,
/obj/structure/railing/corner{
	dir = 8
	},
/obj/machinery/holopad/emergency/command,
/obj/effect/decal/cleanable/dirt/dust,
/turf/open/floor/plasteel/tech,
/area/ship/bridge)
"aI" = (
/obj/effect/turf_decal/steeldecal/steel_decals1,
/turf/open/floor/plasteel/tech,
/area/ship/bridge)
"bo" = (
/obj/structure/closet/wall{
	name = "uniform closet";
	dir = 4;
	pixel_x = -28
	},
/obj/structure/railing/corner{
	dir = 1
	},
/obj/item/storage/bag/ore,
/obj/item/storage/bag/ore,
/obj/item/clothing/under/rank/cargo/miner/lavaland/old,
/obj/item/clothing/under/rank/cargo/miner/lavaland/old,
/obj/item/clothing/shoes/workboots/mining,
/obj/item/clothing/shoes/workboots/mining,
/obj/item/storage/belt/mining,
/obj/item/storage/belt/mining,
/obj/item/t_scanner/adv_mining_scanner,
/obj/item/t_scanner/adv_mining_scanner,
/obj/item/clothing/glasses/meson,
/obj/item/clothing/glasses/meson,
/obj/item/clothing/glasses/meson,
/obj/structure/catwalk/over,
/obj/effect/turf_decal/industrial/warning{
	dir = 6
	},
/turf/open/floor/plating,
/area/ship/medical)
"bq" = (
/obj/structure/cable/yellow{
	icon_state = "0-8"
	},
/obj/machinery/power/apc/auto_name/north,
/obj/structure/bed,
/obj/structure/curtain{
	color = "#808080"
	},
/obj/item/bedsheet/orange,
/obj/machinery/atmospherics/components/unary/vent_scrubber/on/layer4{
	dir = 8
	},
/turf/open/floor/plasteel/grimy,
/area/ship/medical)
"bI" = (
/obj/structure/railing{
	dir = 4
	},
/obj/structure/railing{
	dir = 8
	},
/obj/machinery/atmospherics/pipe/simple/supply/hidden/layer2{
	dir = 6
	},
/turf/open/floor/plasteel/stairs,
/area/ship/bridge)
"bU" = (
/obj/structure/cable/yellow{
	icon_state = "1-2"
	},
/obj/structure/cable/yellow{
	icon_state = "2-4"
	},
/obj/structure/cable/yellow{
	icon_state = "2-8"
	},
/obj/machinery/atmospherics/pipe/manifold4w/supply/hidden/layer2,
/obj/machinery/atmospherics/pipe/manifold4w/scrubbers/hidden/layer4,
/turf/open/floor/plasteel/grimy,
/area/ship/medical)
"ck" = (
/obj/machinery/vending/mining_equipment,
/obj/machinery/firealarm{
	pixel_y = 24
	},
/obj/effect/turf_decal/industrial/warning{
	dir = 1
	},
/obj/structure/railing{
	dir = 1
	},
/obj/machinery/button/door{
	id = "exhumecargo";
	name = "cargo bay";
	pixel_x = -10;
	pixel_y = 25
	},
/turf/open/floor/plasteel/patterned/grid,
/area/ship/storage)
"cG" = (
/obj/machinery/computer/cargo/express{
	dir = 1
	},
/obj/effect/turf_decal/siding/brown{
	dir = 4
	},
/obj/machinery/firealarm{
	dir = 1;
	pixel_y = -25
	},
/obj/machinery/atmospherics/components/unary/vent_pump/on/layer2{
	dir = 8
	},
/obj/machinery/light,
/turf/open/floor/plasteel/patterned,
/area/ship/cargo)
"dK" = (
/obj/machinery/door/airlock/hatch,
/obj/structure/cable/yellow{
	icon_state = "4-8"
	},
/obj/machinery/atmospherics/pipe/simple/supply/hidden/layer2{
	dir = 4
	},
/obj/machinery/atmospherics/pipe/simple/scrubbers/hidden/layer4{
	dir = 4
	},
/obj/machinery/door/firedoor/border_only{
	dir = 4
	},
/obj/machinery/door/firedoor/border_only{
	dir = 8
	},
/turf/open/floor/plasteel/patterned/grid,
/area/ship/engineering)
"dN" = (
/obj/structure/cable/yellow{
	icon_state = "4-8"
	},
/obj/effect/decal/cleanable/dirt,
/obj/item/chair/stool{
	dir = 1;
	pixel_y = 1
	},
/obj/item/broken_bottle{
	pixel_x = 5;
	pixel_y = 7
	},
/obj/effect/decal/cleanable/vomit/old,
/obj/machinery/atmospherics/pipe/simple/supply/hidden/layer2{
	dir = 4
	},
/obj/machinery/atmospherics/pipe/simple/scrubbers/hidden/layer4{
	dir = 4
	},
/turf/open/floor/plasteel/grimy,
/area/ship/medical)
"ei" = (
/obj/machinery/door/airlock/hatch,
/obj/structure/cable/yellow{
	icon_state = "4-8"
	},
/obj/machinery/atmospherics/pipe/simple/supply/hidden/layer2{
	dir = 8
	},
/obj/machinery/atmospherics/pipe/simple/scrubbers/hidden/layer4{
	dir = 4
	},
/obj/machinery/door/firedoor/border_only{
	dir = 4
	},
/obj/machinery/door/firedoor/border_only{
	dir = 8
	},
/turf/open/floor/plasteel/patterned/grid,
/area/ship/storage)
"fn" = (
/obj/structure/chair/comfy/shuttle{
	dir = 8
	},
/obj/effect/decal/cleanable/dirt/dust,
/turf/open/floor/plasteel/tech,
/area/ship/bridge)
"ga" = (
/obj/effect/spawner/structure/window/shuttle,
/obj/machinery/door/poddoor/shutters{
	id = "exhumeBridge"
	},
/turf/open/floor/plating,
/area/ship/bridge)
"gy" = (
/obj/structure/table/wood,
/obj/machinery/atmospherics/components/unary/vent_pump/on/layer2{
	dir = 8
	},
/obj/machinery/light{
	dir = 4
	},
/obj/item/storage/fancy/donut_box,
/obj/item/trash/chips{
	pixel_y = 7;
	pixel_x = 6
	},
/obj/item/reagent_containers/food/drinks/beer{
	pixel_y = 7;
	pixel_x = -8
	},
/turf/open/floor/plasteel/grimy,
/area/ship/medical)
"hc" = (
/obj/structure/railing{
	dir = 8
	},
/turf/open/floor/engine/hull,
/area/ship/external)
"hz" = (
/obj/structure/cable/yellow{
	icon_state = "1-2"
	},
/obj/structure/cable/yellow{
	icon_state = "2-4"
	},
/obj/effect/decal/cleanable/dirt/dust,
/obj/machinery/atmospherics/pipe/simple/supply/hidden/layer2{
	dir = 1
	},
/obj/machinery/atmospherics/pipe/simple/scrubbers/hidden/layer4{
	dir = 1
	},
/turf/open/floor/plasteel/patterned,
/area/ship/cargo)
"ic" = (
/turf/closed/wall/mineral/titanium/nodiagonal,
/area/ship/engineering)
"ik" = (
/obj/structure/railing/corner,
/obj/structure/table/reinforced,
/obj/item/paper_bin{
	pixel_x = -6
	},
/obj/item/pen/fourcolor{
	pixel_x = -4
	},
/obj/item/stamp{
	pixel_x = 8;
	pixel_y = 5
	},
/obj/item/stamp/denied{
	pixel_x = 8
	},
/obj/item/stamp/qm{
	pixel_y = -5;
	pixel_x = 8
	},
/obj/structure/sign/poster/contraband/random{
	pixel_x = -32
	},
/obj/machinery/light{
	dir = 8;
	light_color = "#e8eaff"
	},
/turf/open/floor/plasteel/tech,
/area/ship/bridge)
"il" = (
/obj/structure/closet/wall{
	name = "Utility Closet";
	dir = 4;
	pixel_x = -28
	},
/obj/item/radio,
/obj/item/radio,
/obj/item/radio,
/obj/item/radio,
/obj/item/flashlight,
/obj/item/flashlight,
/obj/item/flashlight,
/obj/item/flashlight,
/obj/effect/decal/cleanable/dirt/dust,
/turf/open/floor/plasteel/patterned/grid,
/area/ship/storage)
"iU" = (
/obj/machinery/power/smes/shuttle/precharged{
	dir = 1
	},
/obj/structure/cable{
	icon_state = "0-2"
	},
/obj/machinery/door/window/eastleft{
	dir = 1;
	name = "Engine Access"
	},
/obj/machinery/door/poddoor{
	id = "osprey_thruster_starboard";
	name = "thruster blast door"
	},
/obj/machinery/atmospherics/pipe/simple/scrubbers/hidden/layer4,
/turf/open/floor/plating,
/area/ship/engineering/electrical)
"jd" = (
/obj/machinery/suit_storage_unit/independent/mining/eva,
/obj/structure/railing,
/obj/effect/turf_decal/industrial/outline/yellow,
/obj/machinery/power/apc/auto_name/south,
/obj/structure/cable/yellow,
/turf/open/floor/plasteel/patterned/grid,
/area/ship/storage)
"jl" = (
/obj/machinery/power/shuttle/engine/electric{
	dir = 1
	},
/obj/structure/cable,
/obj/machinery/atmospherics/pipe/simple/scrubbers/hidden/layer4{
	dir = 9
	},
/turf/open/floor/plating,
/area/ship/engineering/electrical)
"jt" = (
/obj/structure/cable/yellow{
	icon_state = "4-8"
	},
/obj/structure/cable/yellow{
	icon_state = "0-4"
	},
/obj/effect/turf_decal/steeldecal/steel_decals_central7,
/obj/structure/cable/yellow{
	icon_state = "1-4"
	},
/obj/machinery/atmospherics/components/unary/vent_pump/on/layer2{
	dir = 4
	},
/turf/open/floor/plasteel/tech/techmaint,
/area/ship/engineering/electrical)
"lp" = (
/obj/machinery/atmospherics/pipe/simple/scrubbers/hidden/layer4{
	dir = 8
	},
/turf/closed/wall/mineral/titanium,
/area/ship/engineering/electrical)
"lx" = (
/obj/structure/cable/yellow{
	icon_state = "1-2"
	},
/obj/effect/decal/cleanable/dirt,
/obj/structure/chair/stool{
	dir = 4;
	pixel_x = 7;
	pixel_y = 6
	},
/obj/machinery/atmospherics/pipe/manifold/supply/hidden/layer2{
	dir = 8
	},
/obj/machinery/atmospherics/pipe/simple/scrubbers/hidden/layer4{
	dir = 1
	},
/turf/open/floor/plasteel/grimy,
/area/ship/medical)
"lG" = (
/obj/structure/closet/wall/white{
	pixel_y = -30;
	dir = 1
	},
/obj/structure/cable/yellow{
	icon_state = "4-8"
	},
/obj/effect/decal/cleanable/blood/old,
/obj/machinery/firealarm{
	dir = 4;
	pixel_x = -28;
	pixel_y = -28
	},
/obj/item/soap,
/obj/item/storage/firstaid/ancient,
/obj/item/storage/firstaid/medical{
	pixel_x = 6;
	pixel_y = -1
	},
/obj/machinery/atmospherics/pipe/simple/supply/hidden/layer2{
	dir = 8
	},
/obj/machinery/atmospherics/pipe/simple/scrubbers/hidden/layer4{
	dir = 4
	},
/turf/open/floor/plasteel/grimy,
/area/ship/medical)
"mX" = (
/obj/effect/turf_decal/siding/brown{
	dir = 8
	},
/obj/machinery/light{
	dir = 1
	},
/obj/machinery/airalarm/directional/north,
/obj/effect/decal/cleanable/dirt,
/turf/open/floor/plasteel/patterned,
/area/ship/cargo)
"nh" = (
/obj/structure/railing/corner{
	dir = 4
	},
/turf/open/floor/engine/hull,
/area/ship/external)
"no" = (
/obj/structure/table,
/obj/item/stack/spacecash/c1000{
	pixel_y = 14;
	pixel_x = 7
	},
/obj/item/stack/spacecash/c500{
	pixel_y = 9;
	pixel_x = 8
	},
/obj/item/stack/wrapping_paper,
/obj/item/toy/figure/qm{
	pixel_y = 10;
	pixel_x = -10
	},
/obj/item/price_tagger{
	pixel_x = 10;
	pixel_y = 3
	},
/obj/structure/cable/yellow{
	icon_state = "0-8"
	},
/obj/machinery/power/apc/auto_name/north,
/obj/effect/turf_decal/siding/brown{
	dir = 4
	},
/turf/open/floor/plasteel/patterned,
/area/ship/cargo)
"nS" = (
/turf/closed/wall/mineral/titanium,
/area/ship/storage)
"om" = (
/obj/machinery/power/terminal,
/obj/structure/cable/yellow{
	icon_state = "0-8"
	},
/obj/effect/turf_decal/industrial/warning{
	dir = 8
	},
/obj/machinery/atmospherics/components/unary/tank/air{
	piping_layer = 2;
	dir = 8
	},
/turf/open/floor/plasteel/tech/grid,
/area/ship/engineering/electrical)
"ox" = (
/obj/structure/closet/wall/orange{
	dir = 4;
	pixel_x = -30
	},
/obj/item/storage/belt/utility/full,
/obj/item/clothing/glasses/hud/diagnostic,
/obj/item/clothing/suit/space/officer,
/obj/item/clothing/under/utility,
/obj/item/gun/ballistic/automatic/pistol/m1911,
/obj/machinery/atmospherics/components/unary/vent_scrubber/on/layer4,
/turf/open/floor/plasteel/patterned/grid,
/area/ship/engineering)
"sh" = (
/obj/machinery/power/terminal,
/obj/structure/cable/yellow{
	icon_state = "0-4"
	},
/obj/effect/turf_decal/industrial/warning{
	dir = 4
	},
/obj/machinery/airalarm/directional/west,
/obj/structure/closet/wall/orange{
	name = "fuel locker";
	pixel_y = 30
	},
/obj/item/stack/sheet/mineral/uranium/five{
	pixel_y = 10;
	pixel_x = 5
	},
/obj/item/stack/sheet/mineral/uranium/five{
	pixel_y = 5;
	pixel_x = -3
	},
/turf/open/floor/plasteel/tech/grid,
/area/ship/engineering/electrical)
"sD" = (
/obj/machinery/mineral/ore_redemption{
	dir = 8
	},
/obj/structure/railing,
/obj/effect/turf_decal/industrial/hatch/yellow,
/obj/machinery/atmospherics/components/unary/vent_scrubber/on/layer4,
/obj/machinery/light{
	dir = 4
	},
/turf/open/floor/plasteel/patterned/grid,
/area/ship/storage)
"sL" = (
/turf/closed/wall/mineral/titanium/nodiagonal,
/area/ship/storage)
"tq" = (
/obj/structure/railing{
	dir = 4
	},
/turf/open/floor/engine/hull,
/area/ship/external)
"ty" = (
/obj/structure/railing/corner{
	dir = 1
	},
/obj/structure/railing/corner{
	dir = 4
	},
/obj/machinery/door/airlock/public,
/obj/structure/cable/yellow{
	icon_state = "1-2"
	},
/obj/machinery/atmospherics/pipe/simple/supply/hidden/layer2{
	dir = 1
	},
/obj/machinery/door/firedoor/border_only{
	dir = 1
	},
/obj/machinery/door/firedoor/border_only,
/turf/open/floor/plasteel/grimy,
/area/ship/cargo)
"vz" = (
/obj/effect/spawner/structure/window/shuttle,
/obj/machinery/door/poddoor/shutters{
	id = "exhumewindows"
	},
/turf/open/floor/plating,
/area/ship/cargo)
"wb" = (
/obj/structure/cable{
	icon_state = "0-2"
	},
/obj/machinery/power/terminal{
	dir = 1
	},
/obj/structure/cable/yellow{
	icon_state = "4-8"
	},
/obj/machinery/atmospherics/pipe/simple/supply/hidden/layer2{
	dir = 8
	},
/turf/open/floor/plasteel/tech/techmaint,
/area/ship/engineering/electrical)
"wj" = (
/obj/effect/turf_decal/industrial/loading,
/turf/open/floor/plasteel/patterned/ridged,
/area/ship/engineering)
"wF" = (
/turf/closed/wall/mineral/titanium/nodiagonal,
/area/ship/engineering/electrical)
"wH" = (
/obj/effect/decal/cleanable/dirt/dust,
/obj/machinery/light{
	dir = 8
	},
/obj/machinery/airalarm/directional/west,
/obj/machinery/atmospherics/components/unary/vent_pump/on/layer2{
	dir = 4
	},
/turf/open/floor/plasteel/patterned/grid,
/area/ship/storage)
"xA" = (
/obj/machinery/power/smes,
/obj/structure/cable/yellow{
	icon_state = "0-8"
	},
/obj/machinery/firealarm{
	dir = 1;
	pixel_y = 34
	},
/turf/open/floor/plasteel/tech/techmaint,
/area/ship/engineering/electrical)
"xJ" = (
/turf/closed/wall/mineral/titanium,
/area/ship/engineering/electrical)
"yJ" = (
/obj/structure/cable/yellow{
	icon_state = "4-8"
	},
/obj/structure/cable/yellow{
	icon_state = "1-4"
	},
/obj/structure/cable/yellow{
	icon_state = "2-4"
	},
/obj/machinery/atmospherics/pipe/manifold/supply/hidden/layer2,
/obj/machinery/atmospherics/pipe/manifold/scrubbers/hidden/layer4{
	dir = 4
	},
/turf/open/floor/plasteel/tech/techmaint,
/area/ship/engineering/electrical)
"yW" = (
/turf/open/floor/plasteel/patterned/grid,
/area/ship/engineering)
"zN" = (
/turf/closed/wall/mineral/titanium,
/area/ship/bridge)
"Ar" = (
/obj/effect/spawner/structure/window/shuttle,
/obj/machinery/door/poddoor/shutters{
	id = "exhumewindows"
	},
/turf/open/floor/plating,
/area/ship/bridge)
"Aw" = (
/obj/machinery/modular_computer/console/preset/command{
	dir = 8
	},
/obj/machinery/airalarm/directional/north,
/turf/open/floor/plasteel/tech,
/area/ship/bridge)
"Cc" = (
/obj/effect/turf_decal/floordetail/traction,
/obj/effect/turf_decal/industrial/warning{
	dir = 9
	},
/turf/open/floor/plasteel/dark,
/area/ship/engineering)
"CD" = (
/obj/machinery/computer/selling_pad_control{
	dir = 1
	},
/obj/effect/turf_decal/siding/brown{
	dir = 8
	},
/obj/effect/decal/cleanable/dirt/dust,
/obj/machinery/atmospherics/components/unary/vent_scrubber/on/layer4{
	dir = 4
	},
/turf/open/floor/plasteel/patterned,
/area/ship/cargo)
"CS" = (
/obj/structure/chair/comfy/black{
	dir = 8
	},
/obj/effect/turf_decal/siding/brown{
	dir = 4
	},
/obj/effect/decal/cleanable/shreds,
/turf/open/floor/plasteel/patterned,
/area/ship/cargo)
"CT" = (
/obj/effect/decal/cleanable/dirt,
/turf/open/floor/plasteel/patterned/grid,
/area/ship/storage)
"Dy" = (
/obj/machinery/power/port_gen/pacman/super,
/obj/structure/cable,
/obj/effect/turf_decal/industrial/warning{
	dir = 1
	},
/obj/machinery/light/small,
/turf/open/floor/plasteel/tech/techmaint,
/area/ship/engineering/electrical)
"Eq" = (
/obj/structure/cable/yellow{
	icon_state = "4-8"
	},
/obj/effect/decal/cleanable/oil{
	icon_state = "floor6"
	},
/obj/machinery/atmospherics/pipe/simple/supply/hidden/layer2{
	dir = 8
	},
/obj/machinery/atmospherics/pipe/simple/scrubbers/hidden/layer4{
	dir = 5
	},
/turf/open/floor/plasteel/tech/techmaint,
/area/ship/engineering/electrical)
"ES" = (
/obj/machinery/power/terminal,
/obj/structure/cable/yellow,
/obj/effect/turf_decal/industrial/warning{
	dir = 1
	},
/obj/effect/turf_decal/industrial/warning{
	dir = 1
	},
/obj/machinery/atmospherics/pipe/simple/scrubbers/hidden/layer4,
/turf/open/floor/plasteel/tech/grid,
/area/ship/engineering/electrical)
"EY" = (
/obj/structure/cable/yellow{
	icon_state = "4-8"
	},
/obj/machinery/atmospherics/pipe/simple/supply/hidden/layer2{
	dir = 8
	},
/turf/open/floor/plasteel/tech/techmaint,
/area/ship/engineering/electrical)
"Fz" = (
/obj/effect/decal/cleanable/dirt,
/obj/effect/turf_decal/industrial/warning{
	dir = 1
	},
/turf/open/floor/plasteel/patterned/ridged,
/area/ship/storage)
"FV" = (
/obj/structure/railing{
	dir = 4
	},
/obj/structure/railing{
	dir = 8
	},
/obj/structure/cable/yellow{
	icon_state = "1-2"
	},
/obj/machinery/atmospherics/pipe/manifold/supply/hidden/layer2{
	dir = 8
	},
/obj/machinery/atmospherics/pipe/manifold/scrubbers/hidden/layer4{
	dir = 4
	},
/turf/open/floor/plasteel/stairs,
/area/ship/cargo)
"Gh" = (
/obj/machinery/power/apc/auto_name/north,
/obj/structure/cable/yellow{
	icon_state = "0-2"
	},
/obj/structure/tank_dispenser/oxygen,
/turf/open/floor/plasteel/tech/techmaint,
/area/ship/engineering/electrical)
"Gi" = (
/obj/structure/chair/comfy/shuttle{
	dir = 1;
	name = "Helm"
	},
/turf/open/floor/plasteel/tech,
/area/ship/bridge)
"Gr" = (
/obj/machinery/airalarm/directional/west,
/obj/machinery/power/apc/auto_name/south,
/obj/structure/cable/yellow,
/obj/machinery/suit_storage_unit/independent/pilot,
/obj/effect/turf_decal/industrial/warning{
	dir = 9
	},
/turf/open/floor/plasteel/tech/grid,
/area/ship/engineering)
"GM" = (
/obj/effect/turf_decal/spline/fancy/black{
	dir = 5
	},
/obj/structure/bookcase/random/fiction,
/turf/open/floor/plasteel/dark,
/area/ship/bridge)
"HY" = (
/obj/machinery/power/shuttle/engine/electric{
	dir = 1
	},
/obj/structure/cable,
/turf/open/floor/plating,
/area/ship/engineering/electrical)
"IR" = (
/obj/machinery/atmospherics/components/unary/outlet_injector/atmos/atmos_waste{
	dir = 4;
	piping_layer = 1
	},
/turf/open/floor/plating,
/area/ship/engineering/electrical)
"Kb" = (
/obj/structure/cable/yellow{
	icon_state = "2-8"
	},
/obj/effect/turf_decal/steeldecal/steel_decals4,
/obj/effect/decal/cleanable/dirt/dust,
/obj/machinery/atmospherics/pipe/simple/supply/hidden/layer2{
	dir = 1
	},
/obj/machinery/atmospherics/pipe/simple/scrubbers/hidden/layer4{
	dir = 10
	},
/turf/open/floor/plasteel/dark,
/area/ship/bridge)
"KB" = (
/obj/machinery/suit_storage_unit/independent/mining/eva,
/obj/structure/railing,
/obj/effect/turf_decal/industrial/outline/yellow,
/turf/open/floor/plasteel/patterned/grid,
/area/ship/storage)
"KL" = (
/obj/structure/closet/wall{
	name = "Utility Closet";
	dir = 4;
	pixel_x = -28
	},
/obj/item/tank/jetpack/carbondioxide,
/obj/item/tank/jetpack/carbondioxide{
	pixel_x = -4;
	pixel_y = 4
	},
/obj/item/pickaxe/silver,
/obj/item/pickaxe/drill/diamonddrill,
/obj/item/kinetic_crusher,
/obj/effect/decal/cleanable/dirt/dust,
/obj/effect/turf_decal/industrial/warning{
	dir = 1
	},
/turf/open/floor/plasteel/patterned/ridged,
/area/ship/storage)
"KY" = (
/obj/structure/railing,
/obj/structure/table/reinforced,
/obj/machinery/recharger{
	pixel_y = 4;
	pixel_x = 7
	},
/obj/item/gps{
	pixel_x = -6;
	pixel_y = 4
	},
/obj/item/megaphone/cargo,
/turf/open/floor/plasteel/tech,
/area/ship/bridge)
"Le" = (
/obj/structure/cable/yellow{
	icon_state = "1-2"
	},
/obj/structure/cable/yellow{
	icon_state = "1-4"
	},
/obj/effect/turf_decal/steeldecal/steel_decals_central4,
/obj/machinery/atmospherics/pipe/simple/supply/hidden/layer2{
	dir = 1
	},
/obj/machinery/atmospherics/pipe/simple/scrubbers/hidden/layer4{
	dir = 1
	},
/turf/open/floor/plasteel/tech/techmaint,
/area/ship/engineering/electrical)
"LI" = (
/obj/machinery/cryopod,
/obj/structure/railing{
	dir = 4
	},
/obj/machinery/computer/cryopod{
	pixel_y = 26
	},
/obj/structure/railing{
	dir = 8
	},
/obj/machinery/light/small{
	dir = 8;
	light_color = "#d8b1b1"
	},
/obj/machinery/airalarm/directional/west,
/obj/structure/catwalk/over,
/obj/effect/turf_decal/industrial/warning{
	dir = 4
	},
/turf/open/floor/plating,
/area/ship/medical)
"Mp" = (
/obj/machinery/power/smes/shuttle/precharged{
	dir = 1
	},
/obj/structure/cable{
	icon_state = "0-2"
	},
/obj/machinery/door/window/eastleft{
	dir = 1;
	name = "Engine Access"
	},
/obj/machinery/door/poddoor{
	id = "osprey_thruster_starboard";
	name = "thruster blast door"
	},
/turf/open/floor/plating,
/area/ship/engineering/electrical)
"NF" = (
/obj/structure/closet/wall{
	dir = 8;
	icon_door = "orange_wall";
	name = "quartermaster's closet";
	pixel_x = 28
	},
/obj/item/areaeditor/shuttle{
	pixel_x = -3
	},
/obj/item/clothing/neck/cloak/qm,
/obj/item/gun/ballistic/automatic/pistol/deagle,
/obj/item/clothing/suit/armor/riot,
/obj/item/clothing/head/beret/qm,
/obj/item/clothing/under/rank/cargo/qm,
/obj/item/clothing/under/rank/cargo/qm/skirt,
/obj/item/ammo_box/magazine/m50,
/obj/item/ammo_box/magazine/m50,
/obj/machinery/light,
/turf/open/floor/plasteel/dark,
/area/ship/bridge)
"Ok" = (
/obj/structure/fans/tiny,
/obj/machinery/door/poddoor{
	id = "exhumecargo";
	name = "cargo bay blast door"
	},
/turf/open/floor/plating,
/area/ship/storage)
"PC" = (
/turf/closed/wall/mineral/titanium/nodiagonal,
/area/ship/cargo)
"PO" = (
/obj/machinery/computer/crew,
/turf/open/floor/plasteel/tech,
/area/ship/bridge)
"Qc" = (
/obj/machinery/cell_charger,
/obj/structure/table/reinforced,
/obj/item/storage/belt/utility{
	pixel_y = -3
	},
/obj/item/stock_parts/cell/high{
	pixel_y = 7;
	pixel_x = -3
	},
/obj/item/stock_parts/cell/high{
	pixel_y = 5
	},
/obj/effect/decal/cleanable/cobweb,
/obj/machinery/atmospherics/components/unary/vent_scrubber/on/layer4,
/turf/open/floor/plasteel/tech/techmaint,
/area/ship/engineering/electrical)
"Qx" = (
/obj/machinery/selling_pad,
/obj/effect/turf_decal/siding/brown{
	dir = 8
	},
/obj/effect/decal/cleanable/wrapping,
/obj/effect/decal/cleanable/dirt/dust,
/turf/open/floor/plasteel/patterned,
/area/ship/cargo)
"QU" = (
/obj/structure/fans/tiny,
/obj/machinery/door/poddoor{
	id = "exhumebay";
	name = "pod Bay"
	},
/turf/open/floor/plating,
/area/ship/engineering)
"QV" = (
/turf/closed/wall/mineral/titanium/nodiagonal,
/area/ship/bridge)
"Rf" = (
/obj/machinery/door/airlock/hatch,
/obj/structure/cable/yellow{
	icon_state = "1-2"
	},
/obj/machinery/atmospherics/pipe/simple/supply/hidden/layer2{
	dir = 1
	},
/obj/machinery/atmospherics/pipe/simple/scrubbers/hidden/layer4{
	dir = 1
	},
/obj/machinery/door/firedoor/border_only{
	dir = 1
	},
/obj/machinery/door/firedoor/border_only,
/turf/open/floor/plasteel/dark,
/area/ship/bridge)
"Rl" = (
/obj/effect/decal/cleanable/dirt/dust,
/obj/structure/cable/yellow{
	icon_state = "4-8"
	},
/obj/machinery/atmospherics/pipe/simple/supply/hidden/layer2{
	dir = 8
	},
/obj/machinery/atmospherics/pipe/simple/scrubbers/hidden/layer4{
	dir = 5
	},
/turf/open/floor/plasteel/patterned/grid,
/area/ship/storage)
"RZ" = (
/obj/machinery/atmospherics/pipe/simple/scrubbers/hidden/layer4{
	dir = 9
	},
/obj/structure/cable/yellow{
	icon_state = "2-8"
	},
/obj/machinery/atmospherics/components/unary/vent_pump/on/layer2{
	dir = 8
	},
/turf/open/floor/plasteel/patterned/grid,
/area/ship/engineering)
"SG" = (
/obj/structure/frame/computer,
/turf/open/floor/plasteel/tech,
/area/ship/bridge)
"ST" = (
/obj/effect/turf_decal/industrial/loading,
/obj/structure/closet/wall{
	dir = 4;
	icon_door = "yellow_wall";
	name = "engineering closet";
	pixel_x = -28
	},
/obj/item/spacepod_equipment/weaponry/plasma_cutter,
/obj/item/spacepod_equipment/cargo/large/ore,
/obj/machinery/button/door{
	id = "exhumebay";
	name = "Pod bay";
	pixel_x = -24;
	pixel_y = 25
	},
/turf/open/floor/plasteel/patterned/ridged,
/area/ship/engineering)
"SY" = (
/turf/closed/wall/mineral/titanium,
/area/ship/engineering)
"Tg" = (
/obj/machinery/door/airlock/hatch,
/obj/structure/cable/yellow{
	icon_state = "1-2"
	},
/obj/machinery/atmospherics/pipe/simple/supply/hidden/layer2{
	dir = 1
	},
/obj/machinery/atmospherics/pipe/simple/scrubbers/hidden/layer4{
	dir = 1
	},
/obj/machinery/door/firedoor/border_only{
	dir = 1
	},
/obj/machinery/door/firedoor/border_only,
/turf/open/floor/plasteel/tech/techmaint,
/area/ship/engineering/electrical)
"Tq" = (
/obj/machinery/ore_silo,
/obj/structure/railing/corner{
	dir = 8
	},
/obj/item/multitool,
/obj/effect/turf_decal/industrial/hatch/yellow,
/turf/open/floor/plasteel/tech,
/area/ship/bridge)
"Tx" = (
/obj/effect/turf_decal/floordetail/traction,
/obj/structure/sign/poster/contraband/random{
	pixel_y = -32
	},
/turf/open/floor/plasteel/dark,
/area/ship/engineering)
"TB" = (
/obj/structure/cable/yellow{
	icon_state = "1-2"
	},
/obj/effect/decal/cleanable/dirt/dust,
/obj/machinery/atmospherics/pipe/simple/supply/hidden/layer2{
	dir = 1
	},
/obj/machinery/atmospherics/pipe/simple/scrubbers/hidden/layer4{
	dir = 1
	},
/turf/open/floor/plasteel/patterned,
/area/ship/cargo)
"TM" = (
/obj/structure/railing,
/obj/effect/turf_decal/steeldecal/steel_decals9,
/turf/open/floor/plasteel/tech,
/area/ship/bridge)
"Uk" = (
/obj/machinery/computer/helm,
/turf/open/floor/plasteel/tech,
/area/ship/bridge)
"Uu" = (
/obj/structure/cable/yellow{
	icon_state = "1-2"
	},
/obj/structure/cable/yellow{
	icon_state = "1-4"
	},
/obj/effect/decal/cleanable/dirt,
/obj/machinery/atmospherics/pipe/simple/supply/hidden/layer2{
	dir = 1
	},
/obj/machinery/atmospherics/pipe/manifold/scrubbers/hidden/layer4{
	dir = 8
	},
/turf/open/floor/plasteel/grimy,
/area/ship/medical)
"Uy" = (
/obj/effect/turf_decal/floordetail/traction,
/obj/effect/turf_decal/industrial/warning{
	dir = 1
	},
/turf/open/floor/plasteel/dark,
/area/ship/engineering)
"Vb" = (
/obj/effect/decal/cleanable/dirt,
/obj/effect/decal/cleanable/dirt/dust,
/obj/effect/decal/cleanable/plasma,
/obj/structure/cable/yellow{
	icon_state = "2-4"
	},
/obj/machinery/atmospherics/pipe/simple/supply/hidden/layer2{
	dir = 8
	},
/turf/open/floor/plasteel/patterned/grid,
/area/ship/storage)
"Vv" = (
/obj/spacepod/prebuilt,
/obj/effect/turf_decal/floordetail/traction,
/obj/effect/turf_decal/industrial/warning{
	dir = 8
	},
/obj/machinery/light,
/obj/machinery/firealarm{
	dir = 1;
	pixel_y = -25
	},
/turf/open/floor/plasteel/dark,
/area/ship/engineering)
"VL" = (
/obj/structure/table/reinforced,
/obj/item/flashlight/lamp{
	pixel_x = -4;
	pixel_y = 7
	},
/obj/item/spacepod_key{
	pixel_x = -8;
	pixel_y = -10
	},
/obj/item/radio/intercom/wideband{
	pixel_y = 24
	},
/obj/machinery/button/door{
	id = "exhumewindows";
	name = "Window Shutters";
	pixel_x = -25;
	pixel_y = -7;
	dir = 4
	},
/obj/machinery/button/door{
	id = "exhumeBridge";
	name = "Bridge Lockdown";
	pixel_x = -25;
	pixel_y = 6;
	dir = 4
	},
/obj/item/storage/fancy/cigarettes/derringer{
	pixel_x = 9;
	pixel_y = 2
	},
/obj/item/lighter/greyscale{
	pixel_x = 4
	},
/turf/open/floor/plasteel/tech,
/area/ship/bridge)
"We" = (
/obj/structure/railing/corner{
	dir = 1
	},
/turf/open/floor/engine/hull,
/area/ship/external)
"Wv" = (
/turf/open/floor/engine/hull,
/area/ship/external)
"WV" = (
/obj/effect/turf_decal/spline/fancy/black{
	dir = 9
	},
/obj/structure/bed,
/obj/structure/curtain{
	color = "#845f58"
	},
/obj/item/bedsheet/qm,
/obj/machinery/firealarm{
	dir = 4;
	pixel_x = 25
	},
/obj/effect/decal/cleanable/dirt/dust,
/obj/machinery/atmospherics/components/unary/vent_pump/on/layer2{
	dir = 8
	},
/turf/open/floor/plasteel/dark,
/area/ship/bridge)
"Xc" = (
/obj/machinery/autolathe,
/obj/item/stack/sheet/metal/fifty,
/obj/item/stack/sheet/glass/fifty{
	pixel_x = 3;
	pixel_y = -4
	},
/obj/item/stack/sheet/mineral/wood/fifty{
	pixel_x = 4;
	pixel_y = 3
	},
/obj/effect/turf_decal/industrial/warning{
	dir = 1
	},
/obj/machinery/light/small,
/turf/open/floor/plasteel/tech/techmaint,
/area/ship/engineering/electrical)
"Zg" = (
/obj/effect/decal/cleanable/robot_debris/gib,
/turf/open/floor/plasteel/patterned/grid,
/area/ship/engineering)
"Zt" = (
/obj/structure/bed/dogbed,
/mob/living/simple_animal/crab{
	name = "Lord Crabbington"
	},
/obj/structure/cable/yellow{
	icon_state = "0-4"
	},
/obj/machinery/power/apc/auto_name/west,
/obj/machinery/atmospherics/components/unary/vent_scrubber/on/layer4{
	dir = 4
	},
/turf/open/floor/plasteel/dark,
/area/ship/bridge)
"Zx" = (
/turf/template_noop,
/area/template_noop)

(1,1,1) = {"
Zx
Zx
Zx
Zx
Zx
Zx
Zx
Zx
Zx
Zx
nS
sL
sL
sL
sL
nS
Zx
Zx
Zx
Zx
"}
(2,1,1) = {"
Zx
Zx
Zx
Zx
Zx
Zx
Zx
Zx
Zx
Zx
Ok
KL
il
wH
KB
sL
xJ
Zx
Zx
Zx
"}
(3,1,1) = {"
Zx
Zx
Zx
Zx
Zx
Zx
Zx
Zx
Zx
Zx
Ok
Fz
CT
Vb
jd
wF
wF
xJ
Zx
Zx
"}
(4,1,1) = {"
Zx
zN
QV
QV
zN
tq
tq
nh
Wv
Wv
sL
ck
sD
Rl
sL
wF
sh
Mp
HY
Zx
"}
(5,1,1) = {"
QV
QV
VL
ik
QV
QV
QV
vz
vz
vz
PC
sL
sL
ei
sL
Gh
jt
wF
wF
IR
"}
(6,1,1) = {"
ga
PO
fn
KY
GM
Zt
QV
mX
Qx
CD
PC
LI
bo
lG
wF
Qc
Eq
Xc
wF
lp
"}
(7,1,1) = {"
ga
SG
aI
aC
bI
Kb
Rf
hz
TB
FV
ty
Uu
lx
bU
Tg
Le
yJ
ES
iU
jl
"}
(8,1,1) = {"
ga
Uk
Gi
TM
WV
NF
QV
no
CS
cG
PC
bq
gy
dN
wF
xA
wb
Dy
wF
xJ
"}
(9,1,1) = {"
QV
QV
Aw
Tq
QV
QV
QV
vz
vz
vz
PC
ic
ic
dK
wF
wF
EY
wF
ic
Zx
"}
(10,1,1) = {"
Zx
zN
Ar
ga
zN
hc
hc
We
Wv
Wv
QU
ST
ox
RZ
Gr
wF
om
Mp
HY
Zx
"}
(11,1,1) = {"
Zx
Zx
Zx
Zx
Zx
Zx
Zx
Zx
Zx
Zx
QU
wj
yW
Cc
Vv
wF
wF
xJ
Zx
Zx
"}
(12,1,1) = {"
Zx
Zx
Zx
Zx
Zx
Zx
Zx
Zx
Zx
Zx
QU
wj
Zg
Uy
Tx
ic
xJ
Zx
Zx
Zx
"}
(13,1,1) = {"
Zx
Zx
Zx
Zx
Zx
Zx
Zx
Zx
Zx
Zx
SY
ic
ic
ic
ic
SY
Zx
Zx
Zx
Zx
"}
